uint8_t Level_13[] = {
243,0,0,0,0,0,0,243,255,0,0,0,255,250,
0,0,0,0,0,0,0,0,255,0,255,0,255,250,
0,0,0,0,0,251,0,0,255,0,255,0,255,250,
0,0,0,0,0,0,0,0,255,0,255,0,255,250,
242,0,0,251,0,234,0,252,0,0,255,0,255,250,
0,0,0,0,0,0,0,0,255,255,255,0,255,250,
0,0,0,0,0,251,0,0,255,0,0,0,255,252,
0,0,0,0,0,0,0,0,255,0,255,255,255,0,
243,0,0,0,0,0,0,243,255,0,0,0,0,0,
};