uint8_t Level_20[] = {
255,255,0,0,0,0,0,255,255,239,239,239,255,0,
255,0,0,0,0,0,0,236,238,239,239,239,238,243,
0,0,0,0,0,0,0,255,255,239,239,239,255,0,
0,0,0,0,0,0,0,0,255,255,236,255,255,255,
0,235,0,0,234,0,251,0,0,0,0,0,0,250,
0,0,0,0,0,0,0,0,0,0,0,255,255,255,
0,0,0,0,0,0,0,0,0,0,0,0,0,0,
255,0,0,0,0,0,0,0,0,0,0,0,242,0,
255,255,0,0,0,0,0,0,0,0,0,0,0,0,
};