uint8_t Level_01[] = {
250,0,0,255,0,0,0,0,0,0,0,0,241,0,
250,0,0,255,255,0,0,0,0,0,0,0,0,0,
250,0,0,0,0,0,0,0,0,0,0,255,255,255,
250,0,0,255,255,0,0,0,0,251,0,0,0,0,
250,0,0,255,0,0,0,0,0,0,0,255,255,0,
250,0,0,255,0,251,0,0,0,0,0,0,255,0,
250,0,0,255,0,0,0,0,0,0,0,0,255,0,
250,0,0,255,0,234,0,0,0,0,0,0,255,0,
250,0,0,255,0,0,0,0,0,0,0,0,255,250,
};