uint8_t Level_02[] = {
0,0,0,0,0,0,0,0,0,0,0,0,255,255,
0,255,251,255,255,255,255,255,255,255,0,0,0,0,
0,255,0,0,255,0,0,0,0,255,0,0,0,0,
0,255,0,0,255,0,234,0,0,255,0,0,0,0,
0,255,241,0,255,0,0,0,0,255,0,0,0,0,
0,255,255,255,255,0,251,0,0,255,255,255,251,255,
0,255,250,0,255,0,0,0,0,0,0,0,0,0,
0,255,255,0,255,255,255,255,255,255,255,255,255,0,
0,0,0,0,0,0,0,0,0,0,0,0,255,250,
};