uint8_t Level_10[] = {
0,0,0,0,0,0,0,0,0,0,0,0,0,0,0,0,
0,239,0,1,1,1,1,1,1,1,1,1,0,0,243,0,
0,0,0,1,1,1,1,1,1,1,1,1,1,0,150,0,
0,1,1,1,1,1,1,1,1,1,1,1,1,1,1,0,
0,1,1,1,1,1,0,114,0,124,0,146,0,1,1,0,
0,1,1,1,251,1,0,250,0,250,0,250,0,1,242,0,
0,1,1,1,1,1,0,112,0,126,0,148,0,1,1,0,
0,1,1,1,1,1,1,1,1,1,1,1,1,1,1,0,
0,0,0,1,1,1,1,1,1,1,1,1,1,0,150,0,
0,239,0,1,1,1,1,1,1,1,1,1,0,0,243,0,
0,0,0,0,0,0,0,0,0,0,0,0,0,0,0,0,
};
uint8_t Level_10_Details[] = {
1,
2,5,








};


