uint8_t Level_06[] = {
0,0,0,0,0,0,0,0,0,0,0,0,0,0,0,0,
0,1,1,1,1,1,1,242,1,1,1,1,1,0,0,0,
0,1,243,1,1,1,1,1,1,1,1,1,1,1,0,0,
0,1,1,1,1,1,1,1,1,1,1,1,1,1,1,0,
0,1,1,1,1,1,1,251,1,1,1,1,1,1,1,0,
0,1,1,1,1,1,251,239,251,1,1,1,1,1,250,0,
0,1,1,1,1,1,1,251,1,1,1,1,1,1,1,0,
0,1,1,1,1,1,1,1,1,1,1,1,1,1,1,0,
0,1,243,1,1,1,1,1,1,1,1,1,1,1,0,0,
0,1,1,1,1,1,1,1,1,1,1,1,1,0,0,0,
0,0,0,0,0,0,0,0,0,0,0,0,0,0,0,0,
};
uint8_t Level_06_Details[] = {
0,
2,5








};