uint8_t Level_09[] = {
0,0,0,0,0,0,0,0,0,0,0,0,0,0,0,0,
0,239,239,0,1,1,1,1,1,1,1,1,1,1,1,0,
0,239,239,0,1,1,1,1,251,1,1,1,1,243,1,0,
0,0,0,0,1,1,1,1,1,1,1,1,1,1,1,0,
0,1,1,1,1,1,0,0,0,0,0,1,1,0,0,0,
0,1,242,1,1,1,130,250,0,250,114,1,1,0,0,0,
0,1,1,1,1,1,0,0,0,0,0,1,1,0,0,0,
0,0,0,0,1,1,1,1,1,1,1,1,1,1,1,0,
0,239,239,0,1,1,1,1,251,1,1,1,1,243,1,0,
0,239,239,0,1,1,1,1,1,1,1,1,1,1,1,0,
0,0,0,0,0,0,0,0,0,0,0,0,0,0,0,0,
};
uint8_t Level_09_Details[] = {
1,
4,5,








};
