
uint8_t Level_04[] = {
0,0,0,0,0,0,0,0,0,0,250,0,0,0,
0,0,0,0,0,0,255,255,255,255,255,255,255,255,
0,0,0,0,0,0,0,0,0,0,0,0,255,241,
0,0,0,0,0,0,0,0,0,0,0,0,0,0,
0,0,0,0,0,0,0,0,0,0,0,0,0,0,
0,0,0,0,0,251,0,0,0,0,0,0,0,0,
0,0,0,255,255,239,255,255,0,0,0,0,0,0,
0,234,0,255,239,239,239,255,0,0,0,0,0,0,
0,0,0,255,239,239,239,255,0,0,0,0,0,0,
};