uint8_t Level_11[] = {
255,255,255,255,255,255,255,255,255,255,255,255,255,255,255,255,
255,0,0,0,0,0,0,255,243,0,0,0,0,0,243,255,
255,0,0,0,0,0,0,255,0,0,0,0,0,0,0,255,
255,0,0,0,242,0,0,255,0,0,0,0,0,255,132,255,
255,0,0,0,0,0,255,250,255,0,0,0,0,255,250,255,
255,0,251,0,0,0,115,115,115,0,0,0,251,0,134,255,
255,0,0,0,0,0,255,239,255,0,0,0,0,255,239,255,
255,0,0,0,0,0,0,111,255,0,0,0,0,255,255,255,
255,0,0,0,0,0,0,0,255,0,0,0,0,140,250,255,
255,0,0,0,0,0,0,255,255,243,0,0,0,140,250,255,
255,255,255,255,255,255,255,255,255,255,255,255,255,255,255,255,
};
uint8_t Level_11_Details[] = {
1,
4,5,








};