uint8_t Level_03[] = {
255,255,255,255,255,255,255,255,255,255,255,255,255,255,255,255,
255,0,0,0,0,0,0,0,0,0,0,0,0,0,239,255,
255,0,0,0,0,0,0,0,0,0,0,0,241,0,0,255,
255,0,0,0,0,0,0,0,0,0,0,0,0,0,0,255,
255,0,0,0,0,0,0,0,0,0,0,0,0,0,0,255,
255,0,0,0,0,0,0,0,0,0,0,0,0,0,0,255,
255,0,0,0,0,0,0,0,0,0,0,0,0,0,0,255,
255,0,0,0,0,0,0,0,0,0,0,0,0,0,0,255,
255,0,0,0,0,0,0,0,0,0,0,0,0,0,0,255,
255,250,0,0,0,0,0,0,0,0,0,0,0,0,0,255,
255,255,255,255,255,255,255,255,255,255,255,255,255,255,255,255,
};
uint8_t Level_03_Details[] = {
3,
3,8,








};