uint8_t Level_15[] = {
243,132,0,0,0,0,0,0,0,0,0,132,242,255,
255,255,0,234,0,0,0,0,0,251,0,255,255,255,
0,255,0,0,0,255,132,255,0,0,0,255,0,255,
0,255,0,0,255,255,252,255,255,0,0,255,0,255,
0,255,0,0,132,252,250,252,132,0,0,255,0,255,
0,255,0,0,255,255,252,255,255,0,0,255,0,255,
0,255,0,0,0,255,132,255,0,0,0,255,0,255,
0,255,0,251,0,0,0,0,0,0,0,255,0,255,
239,255,0,0,0,0,0,0,0,0,0,255,239,255,
};