uint8_t Level_04[] = {
255,255,255,255,255,255,255,255,255,255,255,255,255,255,255,255,
255,0,0,0,0,0,0,0,0,0,0,250,0,0,0,255,
255,0,0,0,0,0,0,255,255,255,255,255,255,255,255,255,
255,0,0,0,0,0,0,0,0,0,0,0,0,255,241,255,
255,0,0,0,0,0,0,0,0,0,0,0,0,0,0,255,
255,0,0,0,0,0,0,0,0,0,0,0,0,0,0,255,
255,0,0,0,0,0,251,0,0,0,0,0,0,0,0,255,
255,0,0,0,255,255,239,255,255,0,0,0,0,0,0,255,
255,0,0,0,255,239,239,239,255,0,0,0,0,0,0,255,
255,0,0,0,255,239,239,239,255,0,0,0,0,0,0,255,
255,255,255,255,255,255,255,255,255,255,255,255,255,255,255,255,
};
uint8_t Level_04_Details[] = {
3,
2, 8, 








};