uint8_t Level_21[] = {
255,255,255,255,255,255,255,255,255,255,255,255,255,255,255,255,
255,255,0,0,255,250,255,0,0,0,255,0,0,0,255,255,
255,255,251,0,255,250,145,0,0,0,150,0,241,0,255,255,
255,255,0,0,255,250,255,0,0,0,255,0,0,0,255,255,
255,255,235,0,255,255,255,236,255,255,255,255,255,255,255,255,
255,255,0,0,255,255,0,0,0,255,0,0,0,0,255,255,
255,255,236,255,255,255,0,251,0,255,0,255,255,0,255,255,
255,255,0,0,0,255,0,0,0,255,0,255,255,0,255,255,
255,255,0,235,0,0,0,0,0,255,0,255,255,0,255,255,
255,255,0,0,0,255,0,0,0,255,0,0,0,239,255,255,
255,255,255,255,255,255,255,255,255,255,255,255,255,255,255,255,
};
uint8_t Level_21_Details[] = {
3,
7,8,








};




