uint8_t Level_14[] = {
255,255,255,255,255,255,255,255,255,255,255,255,255,255,255,255,
255,0,0,0,255,0,0,0,0,0,0,0,255,239,255,255,
255,0,241,0,255,0,0,0,0,0,251,0,255,113,255,255,
255,0,0,0,255,0,0,0,0,0,0,0,0,0,0,255,
255,0,255,255,255,255,252,0,0,0,0,0,0,0,0,255,
255,0,134,250,128,0,0,0,128,0,0,0,0,0,0,255,
255,0,255,255,255,255,252,0,0,0,0,0,0,0,0,255,
255,0,0,0,255,0,0,0,0,0,0,0,0,0,0,255,
255,0,0,0,134,0,0,0,0,0,251,0,0,0,0,255,
255,0,0,0,255,0,0,0,0,0,0,0,0,0,0,255,
255,255,255,255,255,255,255,255,255,255,255,255,255,255,255,255,
};
uint8_t Level_14_Details[] = {
1,
11,5,








};
