uint8_t Level_06[] = {
0,0,0,0,0,0,242,0,0,0,0,0,255,255,
0,243,0,0,0,0,0,0,0,0,0,0,0,255,
0,0,0,0,0,0,0,0,0,0,0,0,0,0,
0,0,0,0,0,0,251,0,0,0,0,0,0,0,
0,234,0,0,0,251,239,251,0,0,0,0,0,250,
0,0,0,0,0,0,251,0,0,0,0,0,0,0,
0,0,0,0,0,0,0,0,0,0,0,0,0,0,
0,243,0,0,0,0,0,0,0,0,0,0,0,255,
0,0,0,0,0,0,0,0,0,0,0,0,255,255,
};