uint8_t Level_22[] = {
0,0,0,0,0,0,0,0,0,0,0,0,0,0,
0,0,243,0,0,0,0,0,0,0,0,0,0,0,
0,255,255,255,0,0,0,242,0,255,255,255,0,0,
104,236,239,255,0,0,0,0,0,255,239,110,236,255,
250,255,255,255,0,235,0,0,255,255,255,255,104,250,
236,102,239,255,0,0,0,0,255,239,104,236,112,255,
0,255,255,255,0,234,0,0,255,255,255,255,0,0,
0,0,0,0,0,0,0,0,0,0,243,0,0,0,
0,0,0,0,0,0,0,0,0,0,0,0,0,0,
};