uint8_t Level_08[] = {
0,0,0,0,0,0,0,0,0,0,0,0,0,0,0,0,
0,1,1,1,1,1,1,1,1,1,1,1,1,1,1,0,
0,1,0,0,0,0,0,1,1,0,0,0,0,0,1,0,
0,1,1,1,1,250,251,1,1,251,250,1,1,1,1,0,
0,0,251,0,0,0,0,1,1,0,0,0,0,251,0,0,
0,1,1,0,0,0,0,1,1,0,0,0,0,1,1,0,
0,243,1,0,1,1,0,1,1,0,1,1,0,1,242,0,
0,0,0,0,1,251,1,1,1,1,251,1,0,0,0,0,
0,1,1,0,1,1,1,1,1,1,1,1,0,1,1,0,
0,239,1,0,1,1,1,1,1,1,1,1,0,1,239,0,
0,0,0,0,0,0,0,0,0,0,0,0,0,0,0,0,
};
uint8_t Level_08_Details[] = {
3,
7,6,








};

