uint8_t Level_09[] = {
239,239,255,0,0,0,0,0,0,0,0,0,0,0,
239,239,255,0,0,0,0,251,0,0,0,0,243,0,
255,255,255,0,0,0,0,0,0,0,0,0,0,0,
0,0,0,0,0,255,255,255,255,255,0,0,255,255,
0,242,0,234,0,130,250,255,250,114,0,0,255,255,
0,0,0,0,0,255,255,255,255,255,0,0,255,255,
255,255,255,0,0,0,0,0,0,0,0,0,0,0,
239,239,255,0,0,0,0,251,0,0,0,0,243,0,
239,239,255,0,0,0,0,0,0,0,0,0,0,0,
};