uint8_t Level_11[] = {
0,0,0,0,0,0,0,0,0,0,0,0,0,0,0,0,
0,1,1,1,1,1,1,0,243,1,1,1,1,1,243,0,
0,1,1,1,1,1,1,0,1,1,1,1,1,1,1,0,
0,1,1,1,242,1,1,0,1,1,1,1,1,0,132,0,
0,1,1,1,1,1,0,250,0,1,1,1,1,0,250,0,
0,1,251,1,1,1,115,115,115,1,1,1,251,1,134,0,
0,1,1,1,1,1,0,239,0,1,1,1,1,0,239,0,
0,1,1,1,1,1,1,111,0,1,1,1,1,0,0,0,
0,1,1,1,1,1,1,1,0,1,1,1,1,140,250,0,
0,1,1,1,1,1,1,0,0,243,1,1,1,140,250,0,
0,0,0,0,0,0,0,0,0,0,0,0,0,0,0,0,
};
uint8_t Level_11_Details[] = {
1,
4,5,








};