uint8_t Level_17[] = {
255,255,239,0,0,0,0,0,0,0,239,255,255,255,
255,255,0,0,0,0,251,0,0,0,0,255,255,255,
255,255,0,0,255,238,238,238,255,0,0,255,255,255,
255,255,0,0,238,250,0,250,238,0,0,255,255,255,
255,255,0,234,238,0,241,0,238,251,0,255,255,255,
255,255,0,0,238,250,0,250,238,0,0,255,255,255,
255,255,0,0,255,238,238,238,255,0,0,255,255,255,
255,255,0,0,0,0,251,0,0,0,0,255,255,255,
255,255,239,0,0,0,0,0,0,0,239,255,255,255,
};