uint8_t Level_16[] = {
255,255,255,255,255,255,255,255,255,255,255,255,255,255,255,255,
255,250,150,0,0,0,0,0,0,0,0,0,0,150,250,255,
255,150,0,0,0,0,0,0,0,0,0,0,0,0,150,255,
255,0,0,0,0,251,0,251,0,251,0,0,0,0,0,255,
255,0,0,0,251,0,0,0,0,0,251,0,0,0,0,255,
255,0,0,0,0,0,0,0,0,0,0,0,0,0,0,255,
255,0,0,0,251,0,0,0,0,0,251,0,0,0,0,255,
255,0,0,0,0,0,255,164,255,0,0,0,0,0,0,255,
255,150,0,0,0,0,255,241,255,0,0,0,0,0,150,255,
255,250,150,0,0,0,255,255,255,0,0,0,0,150,250,255,
255,255,255,255,255,255,255,255,255,255,255,255,255,255,255,255,
};
uint8_t Level_16_Details[] = {
1,
7,5,








};