uint8_t Level_23[] = {
255,255,255,255,255,255,255,255,255,255,255,255,255,255,255,255,
255,238,250,238,0,0,0,0,0,0,0,0,0,0,236,255,
255,0,236,0,255,0,0,0,0,0,0,0,0,255,250,255,
255,0,242,0,255,0,0,255,255,255,255,255,0,255,255,255,
255,0,0,0,255,0,0,255,0,0,0,255,0,255,255,255,
255,255,255,255,255,0,0,251,0,255,0,235,0,236,243,255,
255,0,0,0,0,0,0,255,255,255,255,255,255,255,255,255,
255,0,251,0,0,0,0,0,0,235,0,0,0,0,0,255,
255,0,0,0,0,0,0,235,0,235,0,235,0,0,0,255,
255,255,255,255,0,0,0,235,0,0,0,235,0,0,0,255,
255,255,255,255,255,255,255,255,255,255,255,255,255,255,255,255,
};
uint8_t Level_23_Details[] = {
3,
13,8,








};
