uint8_t Level_10[] = {
239,255,0,0,0,0,0,0,0,0,0,255,255,243,
255,255,0,0,0,0,0,0,0,0,0,0,255,150,
0,0,0,0,0,0,0,0,0,0,0,0,0,0,
0,0,0,0,0,255,114,255,124,255,146,255,0,0,
0,234,0,251,0,255,250,255,250,255,250,255,0,242,
0,0,0,0,0,255,112,255,126,255,148,255,0,0,
0,0,0,0,0,0,0,0,0,0,0,0,0,0,
255,255,0,0,0,0,0,0,0,0,0,0,255,150,
239,255,0,0,0,0,0,0,0,0,0,255,255,243,
};