uint8_t Level_07[] = {
250,0,0,0,255,239,239,255,0,0,0,0,0,243,
0,0,0,0,255,255,255,255,0,0,0,0,0,0,
0,0,0,0,0,0,0,0,0,0,251,0,0,0,
255,255,255,255,255,255,255,255,0,0,0,234,0,0,
250,250,0,0,0,0,0,0,0,0,251,0,0,242,
255,255,255,255,255,255,255,255,0,0,0,0,0,0,
0,0,0,0,0,0,0,0,0,0,251,0,0,0,
0,255,255,255,255,255,255,255,0,0,0,0,0,0,
0,0,0,0,0,0,250,255,0,0,0,0,0,243,
};