uint8_t Level_09[] = {
255,255,255,255,255,255,255,255,255,255,255,255,255,255,255,255,
255,239,239,255,0,0,0,0,0,0,0,0,0,0,0,255,
255,239,239,255,0,0,0,0,251,0,0,0,0,243,0,255,
255,255,255,255,0,0,0,0,0,0,0,0,0,0,0,255,
255,0,0,0,0,0,255,255,255,255,255,0,0,255,255,255,
255,0,242,0,0,0,130,250,255,250,114,0,0,255,255,255,
255,0,0,0,0,0,255,255,255,255,255,0,0,255,255,255,
255,255,255,255,0,0,0,0,0,0,0,0,0,0,0,255,
255,239,239,255,0,0,0,0,251,0,0,0,0,243,0,255,
255,239,239,255,0,0,0,0,0,0,0,0,0,0,0,255,
255,255,255,255,255,255,255,255,255,255,255,255,255,255,255,255,
};
uint8_t Level_09_Details[] = {
1,
4,5,








};