uint8_t Level_00[] = {
255,255,255,255,255,255,255,255,255,255,255,255,255,255,255,255,
255,0,0,0,0,0,0,0,0,255,255,255,255,255,255,255,
255,0,0,0,0,0,0,0,0,0,0,0,0,0,241,255,
255,0,0,0,0,0,0,0,0,255,255,255,255,255,255,255,
255,0,0,0,0,0,0,0,0,255,0,0,0,0,0,255,
255,255,0,0,0,0,0,0,0,255,0,0,250,0,0,255,
255,255,255,0,250,0,0,0,0,255,0,0,0,0,0,255,
255,255,255,255,255,255,255,255,255,255,255,255,255,255,255,255,
255,255,255,255,255,255,255,255,255,255,255,255,255,255,255,255,
255,255,255,255,255,255,255,255,255,255,255,255,255,255,255,255,
255,255,255,255,255,255,255,255,255,255,255,255,255,255,255,255,
};
uint8_t Level_00_Details[] = {
0,
2,2






};