uint8_t Level_05[] = {
255,255,255,255,255,255,255,255,255,255,255,255,255,255,255,255,
255,255,250,0,0,0,0,0,0,0,0,0,0,255,239,255,
255,255,255,255,255,255,255,255,255,0,0,0,0,255,255,255,
255,255,250,255,0,0,0,255,0,0,251,0,0,0,255,255,
255,255,0,255,0,0,0,0,0,0,0,0,0,0,255,255,
255,255,0,255,0,243,0,0,0,0,251,0,242,0,255,255,
255,255,0,255,0,0,0,0,0,0,0,0,0,0,255,255,
255,255,0,255,0,0,0,0,0,0,0,0,0,0,255,255,
255,255,0,255,255,255,255,255,255,255,0,0,0,255,255,255,
255,255,0,0,0,0,0,0,0,0,0,0,0,255,239,255,
255,255,255,255,255,255,255,255,255,255,255,255,255,255,255,255,
};
uint8_t Level_05_Details[] = {
0,
10,2,








};