uint8_t Level_02[] = {
255,255,255,255,255,255,255,255,255,255,255,255,255,255,255,255,
255,0,0,0,0,0,0,0,0,0,0,0,0,255,255,255,
255,0,255,251,255,255,255,255,255,255,255,0,0,0,0,255,
255,0,255,0,0,255,0,0,0,0,255,0,0,0,0,255,
255,0,255,0,0,255,0,0,0,0,255,0,0,0,0,255,
255,0,255,241,0,255,0,0,0,0,255,0,0,0,0,255,
255,0,255,255,255,255,0,251,0,0,255,255,255,251,255,255,
255,0,255,250,0,255,0,0,0,0,0,0,0,0,0,255,
255,0,255,255,0,255,255,255,255,255,255,255,255,255,0,255,
255,0,0,0,0,0,0,0,0,0,0,0,0,255,250,255,
255,255,255,255,255,255,255,255,255,255,255,255,255,255,255,255,
};
uint8_t Level_02_Details[] = {
0,
7,4,








};