uint8_t Level_07[] = {
255,255,255,255,255,255,255,255,255,255,255,255,255,255,255,255,
255,250,0,0,0,255,239,239,255,0,0,0,0,0,243,255,
255,0,0,0,0,255,255,255,255,0,0,0,0,0,0,255,
255,0,0,0,0,0,0,0,0,0,0,251,0,0,0,255,
255,255,255,255,255,255,255,255,255,0,0,0,0,0,0,255,
255,250,250,0,0,0,0,0,0,0,0,251,0,0,242,255,
255,255,255,255,255,255,255,255,255,0,0,0,0,0,0,255,
255,0,0,0,0,0,0,0,0,0,0,251,0,0,0,255,
255,0,255,255,255,255,255,255,255,0,0,0,0,0,0,255,
255,0,0,0,0,0,0,250,255,0,0,0,0,0,243,255,
255,255,255,255,255,255,255,255,255,255,255,255,255,255,255,255,
};
uint8_t Level_07_Details[] = {
3,
12,4,








};