uint8_t Level_18[] = {
255,0,0,238,239,239,239,255,0,0,0,0,0,255,
255,0,0,255,255,251,255,255,0,0,0,0,0,255,
255,0,0,0,0,0,0,238,0,0,0,255,238,255,
255,0,0,0,0,234,0,238,0,0,0,132,250,255,
255,0,0,0,0,0,0,238,0,0,0,132,250,255,
255,255,255,255,113,113,113,255,0,0,0,132,250,255,
255,255,255,255,250,250,250,255,0,0,0,255,255,255,
255,255,255,255,255,255,255,255,0,0,0,138,250,255,
255,255,255,255,0,241,0,140,0,0,0,138,250,255,
};