uint8_t Level_02[] = {
0,0,0,0,0,0,0,0,0,0,0,0,0,0,0,0,
0,1,1,1,1,1,1,1,1,1,1,1,1,0,0,0,
0,1,0,251,0,0,0,0,0,0,0,1,1,1,1,0,
0,1,0,1,1,3,1,1,1,1,0,1,1,1,1,0,
0,1,0,1,1,3,1,1,1,1,0,1,1,1,1,0,
0,1,0,241,1,3,1,1,1,1,0,1,1,1,1,0,
0,1,0,0,0,0,1,251,1,1,0,0,0,251,0,0,
0,1,0,250,1,0,1,1,1,1,1,1,1,1,1,0,
0,1,0,0,1,0,0,0,0,0,0,0,0,0,1,0,
0,1,1,1,1,1,1,1,1,1,1,1,1,0,250,0,
0,0,0,0,0,0,0,0,0,0,0,0,0,0,0,0,
};
uint8_t Level_02_Details[] = {
0,
7,4,








};



