uint8_t Level_05[] = {
0,0,0,0,0,0,0,0,0,0,0,0,0,0,0,0,
0,0,250,1,1,1,1,1,1,1,1,1,1,0,239,0,
0,0,0,0,0,0,0,0,0,1,1,1,1,0,0,0,
0,0,250,0,1,1,1,1,1,1,251,1,1,1,0,0,
0,0,1,0,1,1,1,1,1,1,1,1,1,1,0,0,
0,0,1,0,1,243,1,1,1,1,251,1,242,1,0,0,
0,0,1,0,1,1,1,1,1,1,1,1,1,1,0,0,
0,0,1,0,1,1,1,1,1,1,1,1,1,1,0,0,
0,0,1,0,0,0,0,0,0,0,1,1,1,0,0,0,
0,0,1,1,1,1,1,1,1,1,1,1,1,0,239,0,
0,0,0,0,0,0,0,0,0,0,0,0,0,0,0,0,
};
uint8_t Level_05_Details[] = {
0,
10,2,








};
