uint8_t Level_08[] = {
0,0,0,0,0,0,0,0,0,0,0,0,0,0,
0,255,255,255,255,255,0,0,255,255,255,255,255,0,
0,0,0,0,250,251,0,0,251,250,0,0,0,0,
255,251,255,255,255,255,0,0,255,255,255,255,251,255,
0,0,255,255,255,255,0,0,255,255,255,255,0,0,
243,0,255,0,0,255,234,0,255,0,0,255,0,242,
255,255,255,0,251,0,0,0,0,251,0,255,255,255,
0,0,255,0,0,0,0,0,0,0,0,255,0,0,
239,0,255,0,0,0,0,0,0,0,0,255,0,239,
};