
uint8_t Level_05[] = {
255,250,0,0,0,0,0,0,0,0,0,0,255,239,
255,255,255,255,255,255,255,255,0,234,0,0,255,255,
255,250,255,0,0,0,255,0,0,251,0,0,0,255,
255,0,255,0,0,0,0,0,0,0,0,0,0,255,
255,0,255,0,243,0,0,0,0,251,0,242,0,255,
255,0,255,0,0,0,0,0,0,0,0,0,0,255,
255,0,255,0,0,0,0,0,0,0,0,0,0,255,
255,0,255,255,255,255,255,255,255,0,0,0,255,255,
255,0,0,0,0,0,0,0,0,0,0,0,255,239,
};