uint8_t Level_00[] = {
255,255,255,255,255,255,255,255,255,255,255,255,255,255,
0,0,0,0,0,0,0,0,255,255,255,255,255,255,
0,234,0,0,0,0,0,0,0,0,0,0,0,241,
0,0,0,0,0,0,0,0,255,255,255,255,255,255,
0,0,0,0,0,0,0,0,255,0,0,0,0,0,
255,0,0,0,0,0,0,0,255,0,0,250,0,0,
255,255,0,250,0,0,0,0,255,0,0,0,0,0,
255,255,255,255,255,255,255,255,255,255,255,255,255,255,
255,255,255,255,255,255,255,255,255,255,255,255,255,255,
};