uint8_t Level_23[] = {
255,255,255,255,255,255,255,255,255,255,255,255,255,255,255,255,
255,243,0,0,0,0,0,0,243,255,0,0,0,255,250,255,
255,0,0,0,0,0,0,0,0,255,0,255,0,255,250,255,
255,0,0,0,0,0,251,0,0,255,0,255,0,255,250,255,
255,0,0,0,0,0,0,0,0,255,0,255,0,255,250,255,
255,242,0,0,251,0,0,0,252,0,0,255,0,255,250,255,
255,0,0,0,0,0,0,0,0,255,255,255,0,255,250,255,
255,0,0,0,0,0,251,0,0,255,0,0,0,255,252,255,
255,0,0,0,0,0,0,0,0,255,0,255,255,255,0,255,
255,243,0,0,0,0,0,0,243,255,0,0,0,0,0,255,
255,255,255,255,255,255,255,255,255,255,255,255,255,255,255,255,
};
uint8_t Level_23_Details[] = {
1,
6,5,








};