uint8_t Level_12[] = {
0,255,0,0,0,0,250,250,0,0,0,0,255,0,
0,255,0,0,0,0,243,243,0,0,0,0,255,0,
0,255,0,0,251,251,251,251,251,251,0,0,255,0,
0,255,0,0,251,0,0,0,0,251,0,0,255,0,
239,255,250,243,251,0,234,242,0,251,243,250,255,239,
0,255,0,0,251,0,0,0,0,251,0,0,255,0,
0,255,0,0,251,251,251,251,251,251,0,0,255,0,
0,255,0,0,0,0,243,243,0,0,0,0,255,0,
0,255,0,0,0,0,250,250,0,0,0,0,255,0,
};