uint8_t Level_01[] = {
0,0,0,0,0,0,0,0,0,0,0,0,0,0,0,0,
0,250,1,1,0,1,1,1,1,1,1,1,1,241,1,0,
0,250,1,1,0,0,1,1,1,1,1,1,1,1,1,0,
0,250,1,1,1,1,1,1,1,1,1,1,0,0,0,0,
0,250,1,1,0,0,1,1,1,1,251,1,1,1,1,0,
0,250,1,1,0,1,1,1,1,1,1,1,0,0,1,0,
0,250,1,1,0,1,251,1,1,1,1,1,1,0,1,0,
0,250,1,1,0,1,1,1,1,1,1,1,1,0,1,0,
0,250,1,1,0,1,1,1,1,1,1,1,1,0,1,0,
0,250,1,1,0,1,1,1,1,1,1,1,1,0,250,0,
0,0,0,0,0,0,0,0,0,0,0,0,0,0,0,0,
};
uint8_t Level_01_Details[] = {
3,
6,8,








};