uint8_t Level_04[] = {
0,0,0,0,0,0,0,0,0,0,0,0,0,0,0,0,
0,1,1,1,1,1,1,1,1,1,1,250,1,1,1,0,
0,1,1,1,1,1,1,0,0,0,0,0,0,0,0,0,
0,1,1,1,1,1,1,1,1,1,1,1,1,0,241,0,
0,1,1,1,1,1,1,1,1,1,1,1,1,1,1,0,
0,1,1,1,1,1,1,1,1,1,1,1,1,1,1,0,
0,1,1,1,1,1,251,1,1,1,1,1,1,1,1,0,
0,1,1,1,0,0,239,0,0,1,1,1,1,1,1,0,
0,1,1,1,0,239,239,239,0,1,1,1,1,1,1,0,
0,1,1,1,0,239,239,239,0,1,1,1,1,1,1,0,
0,0,0,0,0,0,0,0,0,0,0,0,0,0,0,0,
};
uint8_t Level_04_Details[] = {
3,
2, 8, 








};