uint8_t Level_22[] = {
255,255,255,255,255,255,255,255,255,255,255,255,255,255,255,255,
255,0,0,0,0,0,0,0,0,0,0,0,0,0,0,255,
255,0,0,243,0,0,0,0,0,0,0,0,0,0,0,255,
255,0,255,255,255,0,0,0,242,0,255,255,255,0,0,255,
255,104,236,239,255,0,0,0,0,0,255,239,110,236,255,255,
255,250,255,255,255,0,235,0,0,255,255,255,255,104,250,255,
255,236,102,239,255,0,0,0,0,255,239,104,236,112,255,255,
255,0,255,255,255,0,0,0,0,255,255,255,255,0,0,255,
255,0,0,0,0,0,0,0,0,0,0,243,0,0,0,255,
255,0,0,0,0,0,0,0,0,0,0,0,0,0,0,255,
255,255,255,255,255,255,255,255,255,255,255,255,255,255,255,255,
};
uint8_t Level_22_Details[] = {
3,
6,7,








};
