uint8_t Level_20[] = {
255,255,255,255,255,255,255,255,255,255,255,255,255,255,255,255,
255,255,255,0,0,0,0,0,255,255,239,239,239,255,0,255,
255,255,0,0,0,0,0,0,236,238,239,239,239,238,243,255,
255,0,0,0,0,0,0,0,255,255,239,239,239,255,0,255,
255,0,0,0,0,0,0,0,0,255,255,236,255,255,255,255,
255,0,235,0,0,0,0,251,0,0,0,0,0,0,250,255,
255,0,0,0,0,0,0,0,0,0,0,0,255,255,255,255,
255,0,0,0,0,0,0,0,0,0,0,0,0,0,0,255,
255,255,0,0,0,0,0,0,0,0,0,0,0,242,0,255,
255,255,255,0,0,0,0,0,0,0,0,0,0,0,0,255,
255,255,255,255,255,255,255,255,255,255,255,255,255,255,255,255,
};
uint8_t Level_20_Details[] = {
1,
5,5,








};