uint8_t Level_06[] = {
255,255,255,255,255,255,255,255,255,255,255,255,255,255,255,255,
255,0,0,0,0,0,0,242,0,0,0,0,0,255,255,255,
255,0,243,0,0,0,0,0,0,0,0,0,0,0,255,255,
255,0,0,0,0,0,0,0,0,0,0,0,0,0,0,255,
255,0,0,0,0,0,0,251,0,0,0,0,0,0,0,255,
255,0,0,0,0,0,251,239,251,0,0,0,0,0,250,255,
255,0,0,0,0,0,0,251,0,0,0,0,0,0,0,255,
255,0,0,0,0,0,0,0,0,0,0,0,0,0,0,255,
255,0,243,0,0,0,0,0,0,0,0,0,0,0,255,255,
255,0,0,0,0,0,0,0,0,0,0,0,0,255,255,255,
255,255,255,255,255,255,255,255,255,255,255,255,255,255,255,255,
};
uint8_t Level_06_Details[] = {
0,
2,5








};
