uint8_t Level_07[] = {
0,0,0,0,0,0,0,0,0,0,0,0,0,0,0,0,
0,250,1,1,1,0,239,239,0,1,1,1,1,1,243,0,
0,1,1,1,1,0,0,0,0,1,1,1,1,1,1,0,
0,1,1,1,1,1,1,1,1,1,1,251,1,1,1,0,
0,0,0,0,0,0,0,0,0,1,1,1,1,1,1,0,
0,250,250,1,1,1,1,1,1,1,1,251,1,1,242,0,
0,0,0,0,0,0,0,0,0,1,1,1,1,1,1,0,
0,1,1,1,1,1,1,1,1,1,1,251,1,1,1,0,
0,1,0,0,0,0,0,0,0,1,1,1,1,1,1,0,
0,1,1,1,1,1,1,250,0,1,1,1,1,1,243,0,
0,0,0,0,0,0,0,0,0,0,0,0,0,0,0,0,
};
uint8_t Level_07_Details[] = {
3,
12,4,








};