uint8_t Level_00[] = {
0,0,0,0,0,0,0,0,0,0,0,0,0,0,0,0,
0,1,1,1,1,1,1,1,1,0,0,0,0,0,0,0,
0,1,1,1,1,1,1,1,1,1,1,1,1,1,241,0,
0,1,1,1,1,1,1,1,1,0,0,0,0,0,0,0,
0,1,1,1,1,1,1,1,1,0,1,1,1,1,1,0,
0,0,1,1,1,1,1,1,1,0,1,1,250,1,1,0,
0,0,0,1,250,1,1,1,1,0,1,1,1,1,1,0,
0,0,0,0,0,0,0,0,0,0,0,0,0,0,0,0,
0,0,0,0,0,0,0,0,0,0,0,0,0,0,0,0,
0,0,0,0,0,0,0,0,0,0,0,0,0,0,0,0,
0,0,0,0,0,0,0,0,0,0,0,0,0,0,0,0,
};
uint8_t Level_00_Details[] = {
0,
2,2






};