uint8_t Level_19[] = {
255,239,255,0,0,0,0,0,0,0,0,0,255,239,
255,0,255,0,251,0,0,0,0,0,251,0,255,0,
255,0,255,0,0,0,0,238,0,0,0,0,255,0,
255,255,255,0,0,0,144,250,144,0,0,0,255,255,
255,243,144,0,0,238,250,250,250,238,0,0,144,242,
255,255,255,0,0,0,144,250,144,0,0,0,255,255,
255,0,255,0,0,0,0,238,0,0,0,0,255,0,
255,0,255,0,234,0,0,0,0,0,251,0,255,0,
255,239,255,0,0,0,0,0,0,0,0,0,255,239,
};